15 19
pppppppppMRRRRRRRRR
pWWWWWWWpMRRRRRRRRR
MWPPPPPWMMRRRRRRRRR
PWWWWWWWpMRRRRRRRRR
pppppppppMMMMMMMMMM
MMMTTTTTMMppppppppP
rrrXrXTMMMpWWWWWWWp
rRXRRXMMMMMWPPPPPWM
rXRrrXMMPMPWWWWWWWp
rRXRrXTTWMppppppppp
rrRXrXTWWMMWMTTTTTM
RrRXrRTTMTTWRRRRRRR
rrRXRRRRRTWWPPPPPPR
RrrRXXXRRTTMMMPMRRR
RrrrRRRXXXXXXXPMRRR
0
3 0
5 18
-2 -2
0.0
0