30 30
PTMWWWWMWPpWMTMWTMMWPMWWWTWMWp
MMTTPMpWWTMPTTWWWWWMWMMTMWPMWT
pWWMTTTWMPTMMpMMWTMTTpTWTPMMMW
TWMWpPWMTTpMMMpPpPWWPWWWPMWpPp
pWWpMTWMWppPPMWMWTMTTTWWPTpWWM
pMWTWTTWMPMMWMPWTMMTWTppMTWMWM
MTWPWpWPWWpTWWWMPWMTpWpMpTMPMp
MPMpPPTTWMTPMWWPMMMMPPWPWpTPTT
WWTWTMMMMMMMMMMMMMMMMTTpWMTTWW
WPppWWPTMWpMMWMPPPWMTWMPWWpPpM
PMTMWMTMPWMMMMMMMMWMWWTppMWWTW
WPWWWWMWMPWPMPTPWpWWMMTppPMPTP
WWTWMPWMWWMMMMMPTWpMTPpppMpWTW
pWPMWMMMPMpTMMWWWTpWTPWPpWWMTT
MWPTMWMTWMPTMMMPTWTPMTWppTWTPM
PWMTMWMWPMMWPMMTMPTpPpTTMWTpWM
TWTTWWWpWWWTMMPWWTWPPTWWMPMWTP
MMMMPTMMMMMMMMPTMWTPTMpTpTMMTW
PMPMTWWPEWWTpWWWTTWpWWWTMWTWMW
MPPWWTPpMWMMWWPTMWTMTPTMWPMWWW
MPWpMWWTTWMpWWTTPWTppWMPWWMTpT
WMMPPPpWWWWMMWWTTWppMpPWPpWPWW
WMWWWppWMpWMMWWMTTMTPWWPTMMMWM
WPTMTpWpWpWppMMWMpMWpWWWWTWMMW
ppWMpTTWPTTMMWTpWpWTpTWWWWMTWT
TppMMWWMTPWMPWTWWWPppPTpTPPPpT
pWWPTPMMMTpWMpMppMWTWWPPTPpWWP
pWMMWMTpWTpWMWpMWTWppMPMTppTMT
TTWTWWpWTpWPpWMWMWWWMpWWWWPWWT
WMMpMWTWMWpWMMWMWTWWMTpMTTTpMM
4
11 10 0
11 14 0
6 5 0
25 26 0
11 13
11 11
-2 -2
0
18