17 15
MMMMMMMMMMMMMTM
pWpPWMTpWMpMMTM
PTMWMPPMPWWTTMM
WWpPPPTppTPWPMT
PWTpPWMMTppPpMM
WWTpWPpTWWTppPT
TWWTMPWWMTWTMTT
WppWTpMppWpMTPM
MMMMMMMMMMMMMTM
pWpPWMTpWMpMMTM
PTMWMPPMPWWTTMM
WWpPPPTppTPWPMT
PWTpPWMMTppPpMM
WWTpWPpTWWTppPT
TWWTMPWWMTWTMTT
WppWTpMppWpMTPM
MMMMMMMMMMMMWTM
1
4 0 0
15 10
3 5
-2 -2
0.0
0