20 24
PMPPPPPMPPPMMMMMMMMMPPPM
PPPMPMPMPMPMPPPPPPPMPMPM
MMMMPMPMPMPMPMMMMMPMPMPM
PPPPPMPPPMPMPPPPPMPPPMPM
PMMMMMMMMMPMMMMMPMMMMMPM
PMPPPMMPPPPMPPPMPMPPPMPM
PMPMPPPPMMMMPMPMPMPMPPPM
PMMMMPMPPPPPPMPPPMPMMMMM
PPPPMMMMMMMMMMMMMMPMPPPP
MMMPPMMPPPMPPPPPPPPMPMMP
MPMMPPMPMPMPMMMMMMMMPMPP
PPPMMPPPMPMPMPPPMPPPPMPM
PMPPMMMMMPMPPPMPPPMPPMPP
PMMPPPPPPPMMMMMPMMMMMMMP
PPMMMMMMMPPPPMPPMPPPPPPP
MPMPPPPPMPMMMMMMMMMPMMMP
PPMPMMMPMPMPPPMPPPPPMPPP
PMMPMPPPMPMPMPPPMMMPMPMP
PPPPMPMMMPPPMMMMMPMPMPMP
MMMMMPPPPPMPPPPPPPMPPPPP
2
6 2 0
18 17 0
8 1
1 15
-2 -2
0.2
0